Help.

For Sale
An Interactive Fiction by zlaqafor
Release 1 / Serial number 250122 / Inform 7 v10.1.2 / D

Inside

>Out
Can't.

>Outside
Can't.

>outside
Can't.

>Out
Can't.

* * *

Help.

For Sale
An Interactive Fiction by zlaqafor
Release 1 / Serial number 250122 / Inform 7 v10.1.2 / D

Inside

>RESPONSES
>--> The following sets of responses are available:
    RESPONSES ALL
    RESPONSES 1: Standard Rules

* * *

Help.

For Sale
An Interactive Fiction by zlaqafor
Release 1 / Serial number 250122 / Inform 7 v10.1.2 / D

Inside

>e
Can't.

>s
Can't.

>n
Can't.

>w
Out

>e
Can't.

>w
Away
I can breathe.

>w
No... I can't.

* * *

>w
Out

>s
Away
I can breathe.

>s
No... I can't.

>n
His Door.
He's gone.

>e
His Room.

>e
No... I can't.

* * *

>e
Can't.

>w
Out

>s
Away
I can breathe.

Our House.

>n
His Door.
He's gone.

>e
His Room.
Empty.

>w
His Door.
He's gone.

>s
Our House.

>s
No... I can't.

* * *

Help.

For Sale
An Interactive Fiction by zlaqafor
Release 1 / Serial number 250122 / Inform 7 v10.1.2 / D

Inside

>get out of InsideHouse
Can't.

Inside
Can't.Can't.RoomCan't.Can't.Can't.Can't..

>get out of Room
Can't.

* * *

Help.

For Sale
An Interactive Fiction by zlaqafor
Release 1 / Serial number 250122 / Inform 7 v10.1.2 / D

Inside

>get out of ROom
You can't see any such thing.

>get out of Room
You can't see any such thing.

>get out of InsideHouse
But you aren't in anything at the moment.

* * *

Help.

For Sale
An Interactive Fiction by zlaqafor
Release 1 / Serial number 250122 / Inform 7 v10.1.2 / D

Inside

>get out of Room
Can't.

>get out of InsideHouse
I only understood you as far as wanting to get outside.

>leave InsideHouse
I only understood you as far as wanting to leave.

* * *

Help.

For Sale
An Interactive Fiction by zlaqafor
Release 1 / Serial number 250122 / Inform 7 v10.1.2 / D

Inside

>go out
You would have to get out of (I_insidehouse_U1) first.

>get out of (I_insidehouse_U1)
I only understood you as far as wanting to get outside.

>yes
That was a rhetorical question.

* * *

>go out
You would have to get out of (I_insidehouse_U1) first.

>go Out
Can't.

>e
Can't.

* * *

Help.

For Sale
An Interactive Fiction by zlaqafor
Release 1 / Serial number 250122 / Inform 7 v10.1.2 / D

Inside

>land Out
You walk to Out.

Out

* * *

Help.

For Sale
An Interactive Fiction by zlaqafor
Release 1 / Serial number 250122 / Inform 7 v10.1.2 / D

Inside

>n
Can't.

>s
Can't.

>e
Can't.

* * *

Help.

For Sale
An Interactive Fiction by zlaqafor
Release 1 / Serial number 250122 / Inform 7 v10.1.2 / D

Inside

>out
Can't.

Inside

>Out
Can't.

>Out
Can't.

* * *

>out
Can't.

Inside

>Outside
Can't.

>Out
Can't.

* * *

>out
Can't.

Inside

>get out
Can't.

* * *

>out
Can't.

Inside

>get out of InsideHouse
Can't.

>get out of Room
Can't.

* * *

>out
Can't.

Inside

>go out
Can't.

>get out of Room
Can't.

>get out of InsideHouse
Can't.

* * *

>out
Can't.

Inside

>look
In

>w
Out

* * *

>out
Can't.

Inside

>out
But you aren't in anything at the moment.

>s
Can't.

>w
Out

* * *

>out
Can't.

Inside

>outside
Can't.

* * *

Help.

For Sale
An Interactive Fiction by zlaqafor
Release 1 / Serial number 250122 / Inform 7 v10.1.2 / D

Inside

>outside
Can't.

>land Outside
Can't.

>land Out
You walk to Outside.

Outside

* * *

Help.

For Sale
An Interactive Fiction by zlaqafor
Release 1 / Serial number 250122 / Inform 7 v10.1.2 / D

Inside

>w
Out

>e
In

>e
Can't.

* * *

>e
In

>w
Out

* * *

>s
Away
I can breathe.

>n
His Door.

>e
His Room.

>look
His Room.

* * *

>w
Out

>n
You can't go that way.

>n
You can't go that way.

>e
You can't go that way.

>s
You can't go that way.

* * *

>n
His Door.
He's gone.

>s
By House.

* * *

>s
Away
I can breathe.

Our House.

>s
Sidewalk

* * *

>w
Out

>w
Away
I can breathe.

>look
Near His House.

>s
No.. I can't.

>e
No.. I can't.

>e
No.. I can't.

>s
No.. I can't.

>w
No.. I can't.

>n
No.. I can't.